10 10
e e e e e e e e e e
e e e e e w w e e e
e a w w w e w w w e
e e e e e w w e e e
e e e e e e e e e e
e e e e e e e e e e
e e e e e e e e e e
e e e e e e e e e e
e e e e e e e e e e
e e e e e e e e e e