19 9
E E E E E E E e e e e e E E E E E E E
E E E E E E E e e W e e E E E E E E E
E E E E E E E e e w e e E E E E E E E
e e e e e e e e e e e e e e e e e e e
e e e W w e e e e e e e e e w W e e e
e e e e e e e e e e e e e e e e e e e
E E E E E E E e e w e e E E E E E E E
E E E E E E E e e W e e E E E E E E E
E E E E E E E e e e e e E E E E E E E
1
Exercise One
Deliver all signals to all of three receivers

20
2
1 3 4
5 3 4
6
8 13 9 1
8 13 9 7
5 15 15 4
13 20 9 1
13 20 9 7
15 20 15 4
