20 10
E E E E E E E e e e e e E E E E E E E E
E E E E E E E e e W e e E E E E E E E E
E E E E E E E e e w e e E E E E E E E E
e e e e e e e e e e e e e e e e e e e e
e e e A w e e e e e e e e w W e e e e e
e e e e e e e e e e e e e e e e e e e e
E E E E E E E e e e e e E E E E E E E E
E E E E E E E e e w e e E E E E E E E E
E E E E E E E e e W e e E E E E E E E E
E E E E E E E e e e e e E E E E E E E E